0000000000000000000000000000
0111111111111111111111111110
0100101010100000100101001010
0100101010100000100101001010
0100101010100000100101001010
0111111110111111100101111110
0010101010100100111111010100
1111111110101110101001011111
0010100010101110101001010100
0010111110100000101101110100
0010100000100000100101010100
0010100000100000100101010100
0010111111111111111111110100
0010000000100100100010000100
0011111111100111111111111100
0000000000000000000000000000

