0000000000000000000000000000
0111111111111111111111111110
0010101010111101101111110100
0010101010111101101111110100
0010101010111101101111110100
0010101010000000001111110100
0010101110101010101111110100
1111111110101010101111111111
0010111110101010101111110100
0010111110101010101111110100
0010111110101010101111110100
0010111110000000001111110100
0010111110111111101111110100
0010111110111111101111110100
0010111110111111101111110100
0001111110111111101111011000
0000000000000000000000000000

