0000000000000000000
0111111110111111110
0100000010101000000
0101111011111011110
0101001000001001000
0101111110111111110
0100000010101000000
0111111011111011110
0000001000001000000
0111111111111111110
0000000000000000000
