0000000000000000000000000000
0111111111111111111111111110
0010111110111111101111110100
0010111110111111101111110100
0010111110111111101111110100
0010111110000000001111110100
0010111110111111101111110100
1110111110111111101111111111
0010111110111111101111110100
0010111110111111101111110100
0010111110111111101111110100
0010111110000000001111110100
0010111110111111101111110100
0010111110111111101111110100
0010111110111111101111110100
0001111110111111101111111000
0000000000000000000000000000
