0000000000000000000000000000
0111111111111111111111111110
0100001010100000101101000010
0100001010100000101101000010
0100001010100000101101000010
0111111110111111101111111110
0010101110100100101111110100
1111111110101110101111111111
0010101110101110101111110100
0010101110100000101111110100
0010101110100000101111110100
0010101110100000101111110100
0010111111111111111111110100
0010000000100100100000000100
0011111111111111111111111100
0000000000000000000000000000

