0000000000000000000000000000
0111111111111111111111111110
0100101010100000100101001010
0100101010100000100101001010
0100101010100000100101001010
0111111110111111100101111110
0010101010100100111111010100
1111111110101110101001011111
0100100010101110101001010100
0100111110100000101101110100
0100100000100000100101010100
0100100000100000100101011100
0100111111111111111111110100
0100000000100100100010000100
0111111111100111111111111100
0000000000000000000000000000

